------#####
------#   #####
------# #B##  #
------#  PB B #
####### ###   #
#SS  ##  B  ###
#SS       B ##
#SS  ##B  B X#
#SS  ##  BB ##
#######      #
-----#########