----------#######
----------#  SSS#
------#####  SSS#
------#      SPS#
------#  ##  SSS#
------## ##  SSS#
-----### ########
-----# BBB ##
-#####  B B #####
##   #B B   #   #
#X B  B    B  B #
###### BB B #####
-----# BPBP #
-----########