#############
# PPPPP S   #
#  BPB  SSS #
# B P  BSBS #
#  BPB  SSS #
#   P B BBB #
#X  P       #
#############