PPPPPPPPPP
P    PBXPP
# B  PPPPP
#   B BSS#
##########