############
#   P P P S#
# B BP P P #
# B PBP P  #
#XB  P P P #
############