--######
--#   X####
##### B   #
#   ##    ####
# B #  ##    #
# B #  ##### #
## B  B    # #
## B B ### # #
## #  B  # # #
## # #B#   # #
## ###   # # ######
#  B  #### # #SSSS#
#    B    B   SS#S#
####B  B# B   SSSS#
#       #  ## SSSS#
###################